SO ./textures/SO.xpm
WE ./textures/WE.xpm
EA ./textures/EA.xpm
NO ./textures/NO.xpm
F 57,00,255
C 12,14,15

1111111111111111111111111111111111                       
1000000000000001000000000000000001
10100000000000011111111D1111111111
1000000000000000000000000000000001
1000000000000000000000000000000001
1000000000000000000000000000000001
10000000000000011111111D1111111111
10000000000000011111111D1111111111
10000000000000011111111D1111111111
1100000000000000000000000000000001
1111111111111111111111111111111111
1111111111111111111111111111111111                                                   W
